1111111111111
100000EPC0001
1111111111111
