NO ./sprites/wall/cyber_city_wall_2.xpm
SO ./sprites/wall/cyber_city_wall_4.xpm
EA ./sprites/wall/cyber_city_wall_3.xpm
WE ./sprites/wall/cyber_city_wall_1.xpm




    F 79, 148, 68
C 68, 143, 148


1111111
1E00001
1111001
1110001111111111111111111111   1111
1100000000000000000011000011   1001
1111000000000000000011100011   1001
11111111111110000000000000111111011
11100000011110000000000000000000011
11111111111111111110000000000000011
11111111111111111111111000000111111
                    11100000111
111111                1111111
100001
111111